000100000000000
000100001000010
000111111111000
000100000001000
000111110001000
000000010001000
000011110001000
000010010001010
000010010000000
000010000000000
000011111110000
000000000010000
000000000010000
000001000011110
000000000010000

000000000000000
0000000000000A0
000000A00000000
000000000000000
000000000000000
000000000000000
000000000000000
00000000000B0B0
0000000C0000000
000000000000000
0000D0000000000
000000000000000
000000000000000
00000D0000C0000
000000000000000

010000000000000
010000000000000
010000000000000
011100000000000
000111110001000
011100010000000
000100010001000
000000010001000
000000011111100
000000000000100
000000000000100
000000001111100
000000000000100
000000000000100
000000000000100

000000000000000
000000000000000
000000000000000
000000000000000
0000000B000C000
0A0000000000000
000B0000000C000
000000000000000
000000000000000
000000000000000
000000000000000
000000000000000
000000000000000
000000000000000
000000000000A00

000000000000010
000000000000010
000000000000010
000000000000010
000000000011110
000000000010010
000000000010010
000001111110010
000001000000010
000001000000010
000001000000010
000011000000010
000010000000010
011110000000010
010000000000000

000000000000000
000000000000000
000000000000000
000000000000000
000000000000000
000000000000000
000000000000000
000000000000000
000000000000000
000000000000000
000000000000000
000000000000000
000000000000000
0000000000000A0
0A0000000000000